NO assets/textures/grey_stone.xpm
SO assets/textures/purple_stone.xpm
WE assets/textures/red_brick.xpm
EA assets/textures/wood.xpm

F 220,100,0
C 225,30,0

   1111 111
1010S111  
 101101
 111 1111
