NO ./assets/textures/simonkraft/wet_sponge.xpm
SO ./assets/textures/simonkraft/wet_sponge.xpm
WE ./assets/textures/simonkraft/wet_sponge.xpm
EA ./assets/textures/simonkraft/wet_sponge.xpm

F 164,169,20
C 153,204,255

11111
1   1
1 W 1
1   1
11111
