NO assets/textures/grey_stone.xpm
SO assets/textures/purple_stone.xpm
WE assets/textures/red_brick.xpm
EA assets/textures/wood.xpm

F 220,100,0
C 225,30,0

   1111 111
11110S111  
 1 1101
 1  1011
    100111     1
11111111       1
    1  111111111
         101
         111
