NO ./assets/textures/simonkraft/wet_sponge.xpm
SO ./assets/textures/simonkraft/wet_sponge.xpm
WE ./assets/textures/simonkraft/wet_sponge.xpm
EA ./assets/textures/simonkraft/wet_sponge.xpm


F 164,169,20
C 153,204,255

111
1E01
 11
1111
111
